1111111111111111111111111111111111111
1CCCCCCCCCCCCCCCCCCCC1111111111111CC1
1CPCCCCCCCCCCCCCCCCCC1111111111111CC1
111111111111111111CCC1111111111111CC1
111111111111111111CCC1111111111111CC1
111111111111111111CCC1111111111111CC1
111111111111111111CCC1111111111111CC1
111111111111111111CCC1111111111111CC1
111111111111111111CCC1111111111111CC1
111111111111111111CCC1111111111111CC1
111111111111111111CCC1111111111111CC1
111111111111111111CCC1111111111111CC1
111111111111111111CCC1111111111111CC1
111111111111111111CCC1111111111111CC1
1CCCCCCCCCCCCCCCCCCCCCCCCCCCCCCCCCCC1
1CCCCCCCCCCCCCCCCCCCCCCCCCCCCCCCCCCC1
1CC111111111111111CCC1111111111111111
1CC111111111111111CCC1111111111111111
1CC111111111111111CCC1111111111111111
1CC111111111111111CCC1111111111111111
1CC111111111111111CCC1111111111111111
1CC111111111111111CCC1111111111111111
1CC111111111111111CCC1111111111111111
1CC111111111111111CCC1111111111111111
1CC111111111111111CCC1111111111111111
1CC111111111111111CCC1111111111111111
1CC111111111111111CCC1111111111111111
1CC111111111111111CCC1111111111111111
1CC111111111111111CCCCCCCCCCCCCCCCCC1
1CC111111111111111CCCCCCCCCCCCCCCCEC1
1111111111111111111111111111111111111