111111111111111111111111111111111111111111111111111111111111111111
1P000000000000000000C0000000000000000000000000000000000000000000E1
111111111111111111111111111111111111111111111111111111111111111111